............................................................................................................................................
............................................................................................................................................
............................................................................................OO..............................................
.......................OO.................................................................OOOOO.............................................
.......................OOOOOO.........OO..................................................OOOOO.............................................
.......................OOOOOOOOO...OO.OO...................................OO.OO.......OOOOOOO.OO.OO.OOO....................................
.....................OOOOOOOOOOOOOOOO.OO...................OO..............OOOOO.....OOOOOOOOOOOOOOO.OOOOO..................................
.....................OOOOOOOOOO.OOOOO.OOOOOO.........OO..OOOO..............OOOOOOOOO.OOOO.OOOOOOOOOOOOOOOO..................................
.....................OOOOOOOOO.OOOOOOOOOOOOOOO...OOOOOOOOOOOOOOOOOO.........OOOOOOOO...OOOO.OOOOOOOOOO.OOOO.................................
..................OOOOOOOOOOOO.OOOOOOOOOOOOOOOOOOOOOOOOOOOOOOOOOOOO.OO......OOOOOOOOOOOOOOOOOOOOOOOOOOOOOOOOO...............................
..................OOOOOOOOOOOOOOOOOOOOOOOOOOOOOOOOOOOOOOOOOOOO..OOOOOO.....OOOOOOOOOOOOOOOOO.OOOO.OOOOOOOOOOO...............................
...............OO.OO.OOOOOOOOOOOOOOOOOOOOOOOOOOOOOOOOOOOOOOOOO..OOOOOOOO..OOOOOOOOOOOOOOOOOOO.OOOO.OOOOOOOOO.OO.............................
...............OO....OOOOOOOOOOOOOOOOOOOOOOOOOOOO.OOOOOOOOOOOOO..OOOOOOO.OOOOOO.OOOOOOOOOOOOOOOOOOOOOOOOOOOO.OO.............................
.............OOOO...OOOOOOOOOOOOOOOOOOOOOOOOOOOOOOOOOOOOOOOOOOOOOOOOOOOO.OOO..OOOOOO.OOOOOOOOOOOOOOOOOOOOOOO.OO.OO.OO.......................
............OOOOOO..OOOOOOOOOOOOOOOOOOOOOOOOOOOOOOOOOOOOOOOOOOOOOOOOOOOO.OO.OOOOOOOOOOOOOOOOOOOOOOOOOOOOOOOOOOOOOOOOO.......................
............OOOOOO...OOOOOOOOOOOOOOOOOOOOOOOOOOOO.OOOOOOOOOOOOOOOOOOOOOOOO.OOOOOOOOOOOOOOOOOOOOOOOOOOOOOOOOOOOOOOOOOO.......................
..............OOOOOO.OOOOOOOO.OOOOOOOOOOOOOOOOOOOOOOOOOOOOOOOOOOOOOOOOOOOOOOOOOOOOOOOOOOOOOOOO.OOOOOOOOOOOOOOOOOOOOO........................
..............OOOOOOOOOOOOOOOOOOOOOOOOOOOOOOOOOOOOOOOOOOOOOOOOOOOOOO.OOOOOOOOOOOOOOOOOOOOOOOOOOOOOOOOO.OOOO.OOOOOOOOOO......................
...............OOOOOOOOOOOOOOOOO.OOOOOOOOOOOOOOOOOOOOOOOOOOOOOOOOOOOOOO.OOOOOOOOOOOO.OOOOOOOOOOOOOOOOOOOOOOOOOOOOOOOOO.OO...................
..............OOOOOOOOOOOOOOOOOOOOOOOOOOOOOOOOOOOOOOOOOOOOOOOOOOOOOOOOOOOOOOOO.OOOOOOOOOOOOOOOOOOOO.OOOOOOOOOOOOOOOOOOOOO.OO................
..............OOOOOOOOOOOOOOOOOOOOOOOOOOOOOOOOO.OOOOOOOOOOOOOOOOOOOO.OOOOO.OOOOOOOOOOOOOOOOOOOOOOOOOOOOOOOOOOOOOOOOOOOOOOOOOO...............
...............OOOOOOOOO.OOOOO.OOOOOOOOOOOOOOOOOOOOOOOOOOOOOOOOOOOOOOOOOOOOOOOOOOOOOOOOOOOOOOOOOOO.OOOOOOOOOOOOOOOOOOOOOOOOOO...............
...............OOOO.OOOOOOOOOOOOOOOOOOO.OOOOOOOO.OOOOOOOOOOOOOOOOOOOOOOOOOOOOOOO.OOOOOOOOOOOOOOOOOOOOOOOO.OOOOOOOOOOOOOOOOO.OO..............
.............OOOOOOOOOOOOOOOOOOOOOOOOOOOOOOOOOOOOOOOOOOOOOOOOOOOOOOOOOOO.OOOOOOOOOOOOOOOOOOOOOOOOOOOOOOOOOOOOOOOOOOOOOOOOO..OO..............
............OOOOOOOOOOOO.OOOOOOOOOOOOOOOOOOOOOOOOOOOOOOOOOOOOOOOOOOOOOOOOOOOOOOOOOOOOOOOOOOOOOOOOOOOOOOOOOOOOOOOOOOOOOOOOOOOOO..............
............OOOOO...OOOOOOOOOOOOOOOOOOOOOOOOOOOOOOOOOOOOOOOOOOOOOOOOOOOOOOOOOOOOO.OOO.OO.OOOOOOOOOOOOOOOOOO.OOOOOOOOOOOOOOOOOOO.............
............OOOOOOOOOOOOOOOOOOOO.OOOOOOOOOOOOOOOOOOOOOOOO.OOOOOOOOOOOOOOO.OOOOOO.OOOOOOOOOOOOOOOOOOO.OOOOOOOOOOOOO.OO.OOOOOOOOO.............
...........OOOOOOOOOOOOOOOOOOOOOOOOOOOOOOOOOOOOO.OOOOOOOOOOOOOOOOOOOOOOOOOOOOOOOOOOOOOOOOOOOOOOOOOOOOOOOOOOOOOOOOOOOOOOOOOOOOOOOO...........
.........OOOOOOOOOOOOOOOOOOOOOOOOOOOOOOO.OOOOOOOOOOOOOOOOOOOOOOOOOOOOO.OOOOOOOOOOOOOO.OOOOOO.OOOOOOOOOOOOOOOOOOOOOOOOOOOOOOOOOOOO...........
.......OOOOOOOOOOOOOOO.OOOOOOOOOOOOOOOOOOO.OOOOOOOOOOOOOOOOOOOOOOOOOOOOOO.OOOOOOOOOOOOOOOOOOOOOOOOOO.OOOOOOOOOOOOOOOO.OOOOOOOOOOOOO.........
.......OOOOOOOOOOOOOOOOOOOOOOOOOO.OOOOOOOOOOOOOOOOOOOO.OOOOOOOOOOO.OOOOOOOOOOOOOOOOOOOOOOOOOOOOOOOOOOOOOOOO.OOOOOOOOOOOOOOOOOOOOOOO.........
........OO..OOOOOOOOOOOOOOOOOOOOOOOOOOOOOOOOOOOOOOOOOOOOOOOOOOOOOOOOOO.OOOOOOO.OOOOOOOOOOOOOOOOOOOOOOOOOOOOOOOOOOOOOOOOOOOOOOOO.............
.......OOOOOOOOO.OOOOOOOOOOOOOOOOOOOOOOOOOOOOOOOOOOOOOOOOOOOOOOOOOOOOOOOOOOOOOOOOOOOOOOOOOOOOOOOOOOOOOOOOOOOOOOOOOOOOOOOO.OOOOO.............
....OOOOOOOOOOOOOOOOOOOOOOOOOOOOOOOOOOOOOOOOOOOOOOOOOOOOOOOOOOOOOOOOOOOOOOOOOOOOOOOOOOOOOOOOOOOOOOOOOOOOOOOO.OOOOOOOOOOOO.OOOO..............
..OOOOOOOOOOO.OOOOOOOOOOOOOOOOOOOOOOOO.OOOOOOOOOOOOOOOOOOOOOOOOOOOOOOO.OOOO.OOOOOOOOOOOOOOOOOOOOOOOOOOOOOOOOOOOOOOOOOOOOO.OOOO..............
..OOOOOOOOOOOOOOOOOOOOOOOOOOOOOOOOOOOOOOOOOOOOOOOOOOOOOOOOOOOOOOOOOOOOOOOOOOOOOOOOOOOOOOOOOOOOOOOOOOOOOOOOOOOOOOOOOOO.OO.OOOOO..............
....OOOOOOOOOOOOOOOOOOOOOOOOOOOOOOOOOOOOOOOOOOOOOOOOOOOOOOOOOOOOOO.OOOOOOOOOOOOOOOOOOOOOOOOOOOOOOOOOOOOO.OOOOO.OOOOOOOOOOOOOOOO.............
...OOOOOOOOO.OOOOOO.OOOOOOOOOOOOOOOOOOOOOO.OOOOOOOOOOOOOOOOOOOOOOOOOOOOOOOOOOOOOOOOOOOOO.OOOOOOOOOOOOOOOOOOO.OOOOOOOOOOOOOOOOOO.............
OO.OOOOO.OOOOOOOOOOOOOOOOOOOOOOOOOOOOOO.OOOOOOOOOOOOOOOOOOOOOOOOOOOOOOO.OOOOOOOOOOOOOOOOOOOOOOO.OOOOOOOOOOOOOOOOOOOOOOOOOOOOOOOO............
OOOOOOOOOOOOOOOOOOOOOOOOOOOOOOOOOOOOOOOOOOOOOOOOOOOOOOOO.OOOOOOOOOOOOOOOOOOOOOOOOOOOO.OOOOOOOOOOO.OOOOOO.OOOOOOOOOOOOOOOOOOOOOOOOO..........
OOOOOOOOOOOOOOOOOOOOOOOOOOOOOOOOOOOO.OOOOOOO.OOOOOOOOOOOOOOOOOOOOOOOOOOOOO.OOOOOOOOO.OOOOOOOOOOOOOOOOOOOOOOOOOOOOOOOOOOOOOOOOOOOOO..........
OOOOOOOOOOOOOOOOOOOOOOOOOOOOOOOOOOOOOOOOOOOOOOOOOOOOOOOOOOOOOOOOOOOOOOO.OOOOOOOOOOOOOOOOOOOOOOOOOOOOOOOOOOOOOOOOOOOOOOOOOOOO.OOOO...........
.OOOOOOOOOOOOOOOOOOOOOOOOOOOOOOOOOOOOOOOOOOOOOOOOOOOOOOOOOOOOOOOOOOOOOOOOOOOOOOOOOOOO.OOOOOOOOOOOO.OOOOOOOOOOOO.OOOOOOOO.OOOOOOOOOO.........
.OOOOOOOOOOOOOOOOOOOOOOOOOOOOOOOO.OOOOOOOOOOOOOOOOOOOOO.OOOOOOOOOOOOOOOOOO.OOOOOOOOOOOOOOOOOOOOOOOOOOOOOOOOOOOOOOOOOOOOOOOOOOOOOOOO.........
....OOOOOOOOOOO.OOOOOOOOOOOOOOOOOOOOOOOOOOOOOOOOOOOOOOOOOOOOOOOOOOOOOOOOOOOOOOOOOOOOOOOOOOOO.OOOOOOOOOOOOOOOOOOO.OOOOOOOOOOOOOOOOOOO........
...OOO...OOOOOOOOOOOOOOOOOOOOO.OOOOOOOOOOOOOOOOOOOOOOOOOOOOOOOOOOOOO.OOOOOOOOOOOOOOOOOOOOOOOOOOOOOOOOOOOOOOOOOOOOOOOOOOOOOOOOOOOOOOO........
...OOO..OOOOOOOOOOOOOOOOOOOOO.OOOOOOOOOOOOOOOOOOOOOOOOOOOOOOOOOOOOOOOOOOOOOO.OOOOOOOOOOOOOOOO.OOOOOOOOOOOOOOOOOOOOOOOOOOOOOOOOOOOOOOO.......
...OO...OOOOOOOOOOOOOOOOO.OOOOOOOOOOOOOOOOOOOOOOOOOOOOOOOOOOOOOOOOOOOOOOOOOOOOOOOOOOOOOOOOOOOOOOOOO.OOOOOOOOOOOOOOOOOOO.OOOOOOOOOOOOOO......
.........OOOOOOOOOOOOOOOOOOOOOOOOOOOOOOOOOOOOOOOOOOO.OO.OOOOOOOOOOOOOOOOOOOOOOOOOOOOOOOOOOOOOOOOOOOOOOOOOOOOOOOOOOOOOOOOOOOOOOOOOOOOOO......
........OOOOO.OOOOOOOOOOOOOOOOOOOOOOOOOOOOOOOOOO.OOOOOOOOOOOOOOOOOOOOOOOOOOOOOOOOOOOOOOOOOOOOOOO.OOOOOOOOOOOOOOOOOOOOOOO.OOOOOOOOOOOO..OO...
........OOOOOOO.OOOOOOOOOOOOOOOOOOOOOOO.OOOOOOOOOOOOOOOOOOOOOOOOOOOOOOO.OOOOOOOOOOOO.OOOOOOOOOOOOOOOOOOOOOOOOO.OOOOOOOOOOOOOOOOOOOOOOOOOO...
.......OOOOOOOOOOOOOOOOOOOOOOOOOOOOOOOOOOOOOOOOOOOOOOOOO.OOOOOOOOOOOOOOOOOOOOOOOOOOOOOOOOOOOOOOOOOOOOOOOOOOOOOOOOOOOOOOOOOOOOOOOOOOOOOOOO...
.......OOOOOOOOOOOOOOOOOOOOOOOOOOOOOOOOOOOOOOO.OOOOOOOOOOOOOOOOO.OOOOOOOOOOOOOOOO.OOOOOOOOOOOOOOOOOOOOOOOOOOOOOOOOOOOOOOOOOO.OOOOOOOO.OO....
.......OOOOOOOOOOOOOOO.OOOOOOOOOOOOOOOOOOOOOO.OOOOOOOOOOOOOOOOOOOOOOOOOOOOOOOOO.OOOOOOOOOOOOOOOOOOOOOOOOOOOOOOOOOOOOOOOOOOOOOOOOOOOOO.OO....
.........OOOOOOO.OO.OOOOOOOO.OOOOOOOOOOOOOOOOOOOOOOOOOO.OO.OOOOOOOOO.OOOOOOOOOOOOOOOOOOOOOOOOOOOOOOOOOOOOOOOOOOOOOOOOOOOOOOOOOOOOOOOOOO.....
........OOO.OOOOOOOO.OOOOOOOOOOOOOOOOOOOOOOOOOOOOOOOOOOOOOOOOOOOOOOOO.OOOOOOOOOOOOOOOOOOOOOOOOOOOO.OOOOOOOOOOOOOOOOOOOOOOOOOOOOO...OOOO.....
........OOO.OOOOOOOOOOOOOOOOOOOOOOOOOOOOOOOOOOOOOO.OOOOOOOOOOOO.OOOOOOOOOOOOOOO.OOOOOOOOOOO.OOOOOOOOOOOOOOOOOOOOOOOOOOOOOOOOOOOOOO.OOO......
........OOO..OOOOOOOOOOOOOOOOO.OOOOOOOOOOOOOOOOOOOOOOOOOOOOOOOOOOOOOOOOOOOOO.OO..OOOOOOOO.OOOOOOOOOOOOOOOOOOOOOOOOOOOOOOOOOOOOOOOOOOOO......
........OOO..OOOOOOOOO.OOOOOOOOOOOOO.OOOOOOOOOOOOOOOOOOOOOOOOOOOOOOOOOOOOO........OOOOOOOOOOOOOOOOOOOOOOOOOOOOOOO.OOOOOOOO.OO.OOOOO.OO......
........OOOOOOOOOOOOOOOOOOOOOOOOOOOOOOOOOOOOOOOOOOOOOOOOOOOOOOOOOOOOOOOOOOOO.OO.OOOOOOOOOO.OOOO.OOOOOOOOOOOOOOOOOOOOOOOOOOOOOOOOOOOO........
........OOOOOOOOOOOOOOOOOOOOOOOOOOOOOOO.OOOOOOOOOOOOOOOOOOOOOOOOOOOOOOOOOOOOOOOOOOOOOOOOOOOOOOOOOOOO.OOOOOOOOOOOOOOOOOOOOOOOOOOOOOOOOO......
........OOOOOOOOOO..OOOOOOOOOOOOOOOOOOOOOOOOOOOOO.OOOOOO.OO.OO.OOOOOOOOOOOO.OOOOOOOOOOOOOOOOOOOOOOOOOOOOOOOOOOOOOOOOOOOOOOOOOOOOOOOOOO......
.......OOOOOOOOOOOO.OOOOOOOOO..OOOOOOOOOOOOOOOOOOOOOOOO.OOOOOOOOO.OOOOO......OOOOOOOOOOOOOO.OOOOO.OOOOOOOOOOOOOOOOO.OOOOOOOOOOOOOOOO........
.......OOOOOOOOOOOOOOOOOOOOOOOOOOOOOOOOOOOOOOOOOOOOOOOOOOOOOOOO.OOOOOOOO..OOOOOOOOOOOOOOOOOOOOOOOOOOOOOOOOOOOOOOOOOOOOOOOOOOOOOOOO..........
.........OOOOOOO.OOOOOOOOOOOOOOOOOOOOOOOOOO.OOOOOOOOOOOOOOOOOO..OOOOOOOO..OOOOOOOOOOOOOO.OOOOOOOOOOOOOOOOOOOOOOOOOOOOOOOOOOOOOOOOO..........
.........OOOOOOOOOOOOOOOOOO.OOOOOOOOOO.OOOOOOOOOOOOOOO.OOOO.OOO..OOOO......OOOOOOOOOOOOOOOOOOOOOOOOOOOOOOOOOOOOOOOOOOOOOOOOOOOOOO...........
.........OO.OOOOOOOOOOOOOOOOOOO.OOOOOOOOOO.OOOOOOOOOOOOOOOOOOOOOOOOOO........OOOO.OOOOOOOOOOOOOOOOOOOOOOOOOOOOOOO.OOOO.OOOOOOOOOO...........
.......OOOOOOOOOOOOOOOOOOOOOOOOOOOOOOOOOOOOOOOOOOOOOOOOOOOOOOO.OOOOOO........OOOOOOOOOOOOOOOOOOOOOOOOOOOOOOOOOOOO.OO.OOOOOOOOOOOO...........
.......OOOOOOOOOOOOOOOOOOOOOOOOOOOOOOOOOOOOOOOOOOOOOOOOOOOOOOOOOOOOOO........OOOOOOOOOOOOOOOOOOOOOOOOOOOOOOOOOOOOOOOOOOOOOOOOOOOO...........
.......OOOO.OOOOOOOOOOOOOOOOO.OOOOOOOOOOOOOOOOOOOOOOO.OOOOOOOOOOOOO..........OOOOOOOOOOOOOOOOOOOOOO.OOOOOOOOOOOOOOOOOOOOOOOOOOOOOO..........
......OO.....OO.OOOOOOOOOOOOOOOOOOOOOOOOOOOOOOOOOOOOOOOOOOOOOO.OOOO............OOOOOOOOOOOOOOOOOOOOOOOOOOOOOOOOOOOOOOOOOOOOOOOOOOO..........
....OOOOOOOOOOOOOOOOOOOOOOOOOOOOOOOOOOOOOOOOOOOOOOOOOOOOOOOOOOOOOOOO..........OOOOOOOOOOOOOOOOOOOOOOOOOO.OOOOOOOOOOOOOOOOOOOO.OOO...........
....OOOOOOOOOOOOOOOOOOOOOOOOOOOOOOOOOOOO.OOOOOOOOOOOOOO.OOOOOOOOOOOO..........OOOOOOOOOOOOOOOOOOOOOOOOOOOOOOOOOOOOOOOOOOOOOOOOOOO...........
.......OOOOOOOOOO.OOOOOOOOOOOOOOOO.OOOOOOOOOOOOOOOOOOOOOOOOOOOOOOOOOO........OOOOOOOOOOOOOOOOOOOOOOOOOOOOOOOOOOOOOOOOOOOOOOOOOOO............
.......OOOOOOOOOOOOOOOOOOOOOOOOOOOOOOOOOOOOOOOOOOOOOOOOOOOOOOOOOOOOOOOO......OOOOOOOOOOOOOOOOOOOOOOOOOOOOOOOOOOOOOOOO.OOOOOOOOOO.OO.........
.......OOOOOOOOOOOOOOOOOOOOOOOO.OOOOOOOOOOOOOOOOOOOOOOOOOOOOOOOOO..OOOOOOOO...OOOOOOOOOOOOOOO.OOOOOOOOOOOOOOOOOOOOOOOOOOOOOOOOOOOOO.........
.........OOOOOOOOOOOOOOOOOOOOOOOOOOOOOOOOOOOOOOOOOOOOOOOOOOOOOO.OOOOOOOOOOO...OOOOOOOOOOOOOOOOOOOOOOOOOOOOOOOOOOOOOOOOOO.OOOOOOOOOO.........
.......OOOOOOOOOOOOOOOOOOOOO.OOOOOOOOOOOOOOOOOOOOOOOOOOOOOOO.OO.OOOOO.OOOO....OOOOOOOOOOOOOOOOOOOOO.OOOOOOOOOOOOOOOOOOOOOOOOOOOOOO..........
.......OOOOOOOOOOOOOOOOOOOOOOOOOOOOOOOOOOOOOOOOOOOOOOOOOOOOO.OO...OOOOOOOOOOOOOOOOOOO.OOOOOOOOOOOOOOOOOOOOOOOOOOOOOOOOOOOOOOOOOOOOOO........
.......OOOOOOOOOOOOOOOOOOOOOOOOOOOOOOOOOO.OOOO.OOOOOOOOOOOOOOOO.OOOOOOOOOOOOOOOOOOOOOOOOOOOOOOOOOOOOOO.OOOOOOOOOOOOOO.OOOO.OOOOOOOOO........
.......OOOOOOOOOO.OOOOOOOOOOOOOOOOOOOOOOOOOOOOOO.OOOOOOOOOOOOOOOOOOOOOOOOOOOOOOOOOOOOOOOOOOOOOOOOOOOOOOOOOOOOOOO.OOOOOOOOOOOOOOOOOOO........
........OO.OOOOOOOOOOOOOOOOOOOO.OOOOOOOOOOOOOOOOOOOOOOOOOOOOOOOOOOOOOOOOOOOOOOOOOOOOOOOOOOOOOOOOOOOOOOOOOOOOOOOOOOOOOOOOOOOO.OOOOOOO........
........OOOOOOOOOOOOOOOOOOOOOOOOOOOOO.OOOOOOOOOOOOOOOOOO.OOOOOOOOOOOOOOOO.OOOOO.OO.OOOOO.OO.OOOOOOOOOOOOOOOOOOOOOOOOOOOOOOOOOOOOOO..........
..........OOOOOOOOOOOOOOOOOOOOOOOOOOOOOOOOOOOOOO.OOOOO.OOOOOOOOOOOOOOOOOOOOOOOOOOOOOOOOOOOOOOOOOOOOOOOOOOO.OOOO.OOOOOOOOOOOOOOOOOOOO........
...........OO.OOOOOOOOOOOOOOOOOOOOOOOOOOOOOOOOOOOOOOOOOOOOOOOOOOOOOOO.OOOOOOOO.OOOOOO.OOOOOOOOOOOOOOOOOOOOOOOOOOOOOOOOOOOOOOOOOOOOOO........
...........OOOOOOOOOOOOOOOOOOOOOOOOO.OO.OOOOOOOOOOOOOOOOOOOOOOOOOOOOOOOOOOOOOOOOOOOOOOOOOOOOOOOOOOOOOOOOOOOOOOOOOOOOOOOOOOO.OOOOOOOO........
.............OOOOOOOOOOOOOOOOOOOOOOOOOOOOOOOOOOOOOOOOOOOOOOOOO.OOOOOOOOOOOOOOOOOOOOOOOOOOOOOOOOOOOOO.OOOOOOOOOOOOOOOOOOOOOOOOOOOOO..........
............OOOOOOOOOOOOOOOOOOOOOOOOOOOOOOOOOOOOOOO.OOOOOOOOOOOOOOOOOOOOOOOOO.OOOOOO.OOOOOOOOOOOOOOOOOOOOOOOOOOOOOOOOOOOOO.OOOOOOOOOO.......
............OOOOOOOOOO.OOOOOOOOOOOOO.OOOOOOOOOOOOOOOOOOOO.OOOOOOO.OOOOOOOOOOOOOOOOOOOO.OOOOOOOOO.OOOOOOOOOOOOOOOOOOOOOOOOOOOOOOOOOOOO.......
............OOOOOOOOOOOO.OOOOOOOOOOOOOOOOOOOOOOOOOOOOOOOOOOOOOOOOOOOOOOOOOOOOOOOOOOOOOOOOOOOOO.OOOOOO.OOOOOOOOOOOOOOOOOOOOOOOOOOOOOOO.......
..............OOOOOOOOOOOOOOOOOOOO.OOOOOOOOOOOOOOOOOOO.OOOOOOOOOOOOOOOOOOO.OOOOOOOOOOOOOO.OOOOOOOOOOOOOOOOOOOOOOOOOOOOOOOOOOOOOOOOOOO.......
............OOOOOOOOOOOOOOOOOOOOOOOOOOOOOOOOOOOOOOOOOOOOOOOOOOOOOOOOOOOOOOOOOOOOOOOOOOOOOOO.OOOOOOOOOOOOOOOOOOOOOOOOOOOOOOOOOOOOOOO.........
............OOOOOOOOOOOOOOOOOOOOOOOOOOOOOOOOOOOOOOOOOOOOOOOOOOOOOOOOOOOOOOOOOOOOOOOOOOOOOOOOOOOOOOOOOOOOOOOOOOOOOOOOOOOOOOOOO.OOOOO.........
.............OOOOOOOOOOOOOOOOOOOOOOOOO.OOOOO.OOOOOOOOO.OOOOOOOOOOOOOOOOOOOOOOOOOOOOOOOOOOOOOOOOOOOOOOOOOOOOOOOOOOOOOOOOOOOOOOOOOOOOO........
..............OOOO.OOOOOOOOOOOOOOOOOOOOOOOOOOOOOOOOOOOOOOOOOOOOOOOOOOOO.OOOOOOOOOOOOOOOOOOOOOOOOOOOOOOOOOOOOOOOOOOOOOOOOOOOOOOOOOOOO........
............OOOOOOOOOOOOOOOOOOOOOOOOOOO.OOOOOOOOOO.OO.OOOOOOOOO.OOOOOOOOOOOOOOOOOOOOOOOO.OOOOOOOOOOOOOOO.OOOOOOOOOOOOOOOOOOOOOOOO.OO........
............OOOOOOOOOOOOOOOOOOOOOOOOOOOOOOOOOOOOOOOOOOOOOOOOOOOOOOOOOOOOOOOOOOOOOOOOOOOOOOO.OOOOOOOOOOOOOOOOOOOOOOOOOOOOOOOOOOOOOO..........
..........OOOOOOOOOOOOOOOOOOOOOOOOOOOOOOOOOOOOOOOOOOOOOOOOOOOOOOOOOOOOOOOOOOOOOOOOOOOOO.OOOOOOOOOOOOOOOOOOOO.OOOOOOOOOOOOOOOOOOOOO..........
..........OOOOOOOOOOOOOOOOOOOOOOOOOOOOOOOOOOOOO.OOOOOOOOO.OOOOOOOOOOOOOOOOOOOOOOOOOOOOOOOO.OOO.OOOOOOOOOOOOOOOOOOOOOOOOOOOOOOOOOO...........
...........OOOOOOOOOOOOOOOOOOOOOOOOO.OOOOOOOOOOOOOOOOOOOOOOOOOOOOOOOOOOOOOOOOOOOOOOOOOOOOOOOOOOOOOOOOOOOOOOOOOOOOOOOOOOOOOO..OOOO...........
...........OOOOOOOOOOOOOOOOOOOOOOOOOOOOOOO.OOOOOOOOOOO.OOOOO.OOOOOOOOOOOOOOOOOOOOOOOOOOOOOOOOOOOOOOO.OOOOOOOOOOOOOOOOOOOOOOOOOO.............
............OOOOOOOOOOOOOOOOOOOOOOOOOOO.OOOOOOOOOOOOOOOOOOOOO.OOOOOOOOOO.OOOOOOOOOOOOOOOOOOOOOOOOOOOOOOOOOOOOOOOOOOOOOOOOOOOOOOO............
..............OOOOOOOOOOOOOOOOOOOOOOOO.OOOOOOO.OOOO.OOOOOOOOOOOOOOOOOOOOOOO.OOOOOOO.OOOOOOOOOOO.OOOOOOOOOOOOOOOO.OOOOOOOOOOOOOOO............
..............OOOOOOOOOOOOOOOOOO.OOOOOOOOOOOOOOOOOOOOOOOOOOOOOOOOOOO..OOOOOOOOOOOOOOOOOOOOOOOOOOOOOOOOOOOOOOOOOOO.OO.OOOOOOOOOO.............
...............OOOOOOOO.OOOOOOOOOOOOOOO.OOOOOOOOOOOOOOOOOOOOOOO..OO..OOOOOOOOOOOOOOOOOOOOOOOOOOOOOOOOOOOOOO.OOOOOOOOOOOO.OOOO...............
...............OOOOOOOOOOOOOOOOOOOOOOOOOOOOOOOOOOOOOOOOOOOOOOOOOOOOOOOOOOOOOOOOOOOOOOOOOOOOOOOOOOOOOOOOOOOOOOOOOOOOOOOOO.OOOO...............
...............OOOOOOOOOOOOOOOOOOOOOOO.OOOOOOOOOOOOOOOOOOOOOOOOOOOOOOOOOOOOOOOOOOOOO.OOOOOO.OO.OOOOOOOOOOOOOOOOOOOOOOOOOOOOOO..OO...........
..............OO.OO.OOOOOOOOOOOOOOOOOOOOOOOOOOOOOOOOOOOOOOOOOOOOOOOOOOOOOOOOOOOOOOOOOOOOOOOOOOOOOOOOOOOOOOOOOOOOOOOOO.OOOOOOO..OO...........
..............OOOOOOOOOOOOOOOOOOOOOOOOOOOOOOOOOOOOOOO.OOOOOOOOOOOOOOOOOOOOOOOOOOOOOOOOOOOOOOOOOOOOOOOOOOOOOOOOOOOOOOOOOOOOOOOOOOOO..........
...........OO.OOOOOOOOOOOOOOOOOOOOO.OO.OOOOOOOOOOOOOOOOOOOOOOOOOOOOOOOOOOOOOOOOOOOOOOOOOOOOOOOOOOOOOOOOOOOOOOOOOOO.OOOOOOOOOOOOOOOOO........
..........OOOOOOOOOOOOOOOOOOOOOOOOOOOOOOOOOOO.OOOOOOOOOOOOOOOOOOOOOOOOOOOOOO.OOOOOOOOOOOOO.OOOOOOOOOOOOOOOOOOOOOOOOOOOOOOOOOOOOOOOOO........
..........OOOOOOOOOOOOOOOOOOOOOOOOOOOOOOOOOOOOOOOOOOOOOOOOOOOOOOOOOOOOOOOOOOOOOOOOOO.OOOOOOOOOOOOOOOOO.OOOOOOOOOOOOOOOOOOOOOOOOOOOOO........
...........OOOOOOOOOOOOOOOO.OOOOOO.OOOOOOOOOOOOOOOOOOOOOOOO.OOOOOOOOOOOOOOOOOOOOOOOOOOOOO.OOOOOO.OOOOOOOOOO.OOOOOO.OOOOOOOOOOOOOO...........
............OOOOOOOOOOOOOOOOOOOOOOOOOOOOOOOOOOOOOOO.OOOOOOOOOOOOOOOOOOOOOOOOOOOOOOOOOOOOOOOOOOOOOOOOOOOOOOOOOOOOO.OOOOOOOOOOOOOOOO..........
............OOOOOOOOOOOOOOOOOOOOOOOOOOOOOOOO.OOOOOOOOOOOOOOOOOOOOOOOOOOOOOOOOOOOOOOOOOOOOOOOOOOOOOOO.OOOOOOOOOO.OOOOOOOOOOOOOOOOOOO.........
.............OOOOOOOOOOOOOOOOOOOOOOOOOOOOOOOOOOOOOOOOOOOOOOOOOOOOOOOOO.OOOOO.OO.OOOOOOO.OOOOOOOOOOOOOOOOOOOOOOOOOOOOOOOOOOOOOOOOOOO.........
...............OOO..OOOOOOOOOOOOOOOOOOOOOOOOOOOOOOOOOOOOOO.OOOOOOOOOOOOOOOOOOOOOOOOOOOOOOOOOOOOOOOOOOOOOOOOO.OOOOOOOOOOOOOOOOOOOO...........
...............OOO.OOOOOOOOOOOOOOOOOOOOOOOO.OOOOOO.OOOOOOOOOOOOOOOO.OOOOOOOOOOOOOOOOOOOO.OOOOOOOOOOO.OOOOOOOO.OOOOOOOOOOOOOO..OOO...........
................OO.OOOOOOOOOOOOOOOOO.OOOOOOOOOOOOOOOOOOOOOOOOOOOOOOOOOOOOOOO.OOOOOOOOOO.OOOOOOOOOOOOOOOOOOOOOOOOOOOOOOOOOOOOO..OO...........
...................OOOOOOOOOOOOOOOOOOOOOOOOOOOOOOOOOOOOOOOOOOOOOOOOOOOOO.OO.OOOOOOOOOOOOOOOOOOOOOOOOOOOOOOOOOOOOOOOOOO.OO.OOO...............
..................OOOOOOOOOOOOOOOOOOOOOOOOOOOOOOOOOOO.OOOOOOOOOOOOOOOOOOOOOOOOOOO.OOOOOOOOOOOOOOOOOOOOOOOOOOOOOOOOOOOOOOOOOOO...............
..................OOOOOOOOOOOOOOOOOOOOOOOOOOOOOOOOOOOOOOOOO.OOOOOOOOOOOOOOOO.OOOOOOOOOOOOOOOOOOOOOOOO.OOOOOO.OOOOOOOOOOOOOOOO...............
.................OOOOO.OO.OOOO.OOOOOOOOOOOOOOOOOOOOOOOOOOOO.OOOOOOOOOOOOOOOOOOOOOOOOOOOOOOOOOOOOOOOOOOOOOOOOOOOOOOOOOOOOOO..................
.................OOOOOOOOOOOOOOOOO.OOOOOOOOOO.OOOOOOOOOOOOO.OOOOOOOOOOOOOOOOOOOOOOOOOOOOOOOOOOOOOOOOOO.OOOO.OOOOOOOOOOOOOO..................
..................OOOOOOOOOOOOOOOOOOOOOOOOOOOOOOOOOOOOOOOOOO.OOOOOOOOOOOOOOOOOOOOOOOOOOO.OOOOO.OOO.OOOOOOOOOOOOOOOOOOOOOO...................
..................OOOOOOOOOOOO.OOOOOOOOOOOOOOOOOOOOOOOOOOOOO.OOOOOOOOOOOOOOOOOOOOOOOOOOOOOOOOOOOOOOOOOOOOOOOOOOOOOOOOOO.....................
................OOOOOOOOOOOOOOOOOOOOOOOOOOOOOOOOO..OOO.OOOO...OO.OOOOOOOOOOOOOOOO.OOOOOOOOOOOOOOOOOOOOOOOOO.OOOO.OOOOOOOO...................
................OOOOOOOOOOOOOOOOOOOOOOOOOOOOOOOOO..OOO...OO..OOOOOOOOOOOOOO...OOOOOOOOOOOOOOOOOOOO.OOOOOOOOOOOO..OOOOOOOO...................
...................OO...OOOOOOOOOOOOOOOOOOOOOOOOO..OO........OOOOOOOOOOOOOOO..OOOO.OOOOOO.OOOOOOOOOOOOO.OOOOOOOO..OOOOOO....................
........................OOOOOOOOOOOOOOOOOOOOOO..................OOOOOOOOOOOO.OOOOOOOOOOOOOOOOOOOOOOOOOOOOOOOOOOO.OOOOOOO....................
........................OOOOOOOO.OOOOO.OO.......................OOO..OO...OO.OOO..OOOOO..OOOOOOOOOO..OOO.OOOO....OOOOO......................
........................OOOOOOOOOOOOOO.OO.......................OO...OO.......OOO.OO.OOOOOOOOOOOOOO.OOOO.........OOOO.......................
..........................OOOOO.OOOOOOOO......................................OOOOOO...OOOOOOOO.OOOOOOOO...........OO.......................
............................OOOOOOOOOOOOO......................................OOO........OOOOOOO.OOOOOO....................................
.............................OOOO.OOOOOOO.................................................OOOOOOO...OOO.....................................
.........................OOOOOOOO...OOOO......................................................OO....OOO.....................................
.........................OOOOOOOO....OOOO............................................................OO.....................................
...........................OOOOOO....OOOO...................................................................................................
...........................OOOO.............................................................................................................
............................................................................................................................................