.........
.........
.....#...
...##....
....#....
.....#...
....#....
...#.....
.........
.........

.........
.........
.....#...
...##....
....#....
.....#...
....#....
...#.....
.........
.........

.........
.........
.....#...
...##....
....#....
.....#...
....#....
...#.....
.........
.........

.........
.........
.....#...
...##....
....#....
.....#...
....#....
...#.....
.........
.........