..............
......###.....
....#######...
..####.##.#...
..#.###.###...
..######..#...
..#.#.#.###...
..#.##.#..#...
..##.######...
...######.....
..............
..............