.....#.....#.#.#....
....#.....#.#.#.#...
...#.....#.#.#.#.#..
..#.......#.#.#.#.#.
.#.......#.#.#.#...#
#.......#...#.#.#...
.......#...#.#...#.#
#.....#...#.......#.
.#...#.....#.....#.#
#.#.#.......#...#...
.###.......#.#.#...#
.####.....#...#...#.
#..##....#...#.#.#..
..#.##..#...#...##..
.#...###.#.#....###.
#.....###.#.#..##.##
.......###.#.###...#
........###.###.....
.......#.#####.#...#
......#..####.#.#.#.