....................
....................
....................
....................
....................
....................
....................
....................
....................
....................
....................
..#.................
.###................
#####...............
######..............
#######.............
########............
#########...........
##########..........
#########...........