#.######
#.<..^<#
#<<.<..#
#<>.>>.#
#.^v>^.#
######.#